WWWWWWWWWWWWWWWWWWWW
WWWW    WW WWWWWWWWW
WWWW M  WW WWWWWWWWW
W       WW WWWW E  W
W WW  WWW   WWW    W
W WW  WW    WWW    W
W WWWWW      WW    W
W WWWW  S  S  WWWW W
W   M       M  WWW W
WW WW    M         W
WW WWW  S  S  WW WWW
WW WWWW      WWW WWW
WW WWWWW    WWWW WWW
WW WW  WW  WWWWW WWW
WW WW  WWWWWWWWW WWW
WW WW  WWWW      WWW
W   WW WWWW      WWW
W A      WW   WWWWWW
W   WWWWWWW   WWWWWW
WWWWWWWWWWWWWWWWWWWW