WWWWWW
WEM  W
W    W
W   SW
W  SAW
WWWWWW