WWWWWW
WEM  W
W  S W
W    W
W   AW
WWWWWW